Y Y Y Y Y Y Y Y Y X X X X X Y Y Y Y Y Y Y Y Y
Y Y Y Y Y Y X X X X 4 7 7 X X X X Y Y Y Y Y Y
Y Y Y Y X X X 5 4 4 8 3 3 4 6 3 X X X Y Y Y Y
Y Y Y X X 1 4 5 1 1 1 4 5 1 7 1 3 5 X X Y Y Y
Y Y X X 4 9 4 9 6 7 5 5 5 8 7 6 6 8 5 X X Y Y
Y Y X 3 7 2 9 8 3 5 6 7 3 9 1 8 7 5 8 5 X Y Y
Y X X 1 4 7 8 4 2 0 2 7 1 1 8 2 2 7 6 3 X X Y
Y X 7 2 1 9 5 5 3 1 1 3 1 3 3 4 2 8 6 1 3 X Y
Y X 4 2 6 7 2 5 2 4 2 2 5 4 3 2 8 1 7 7 3 X Y
X X 4 1 6 5 1 1 1 9 1 4 3 4 4 3 1 9 8 2 7 X X
X 4 3 5 2 3 2 2 3 2 4 2 5 3 5 1 1 3 5 5 3 7 X
X 2 7 1 5 1 1 3 1 5 3 3 2 4 2 3 7 7 5 4 2 7 X
X 2 5 2 2 6 1 2 4 4 6 3 4 1 2 1 2 6 5 1 8 8 X
X X 4 3 7 5 1 9 3 4 4 5 2 9 4 1 9 5 7 4 8 X X
Y X 4 1 6 7 8 3 4 3 4 1 3 1 2 3 2 3 6 2 4 X Y
Y X 7 3 2 6 1 5 3 9 2 3 2 1 5 7 5 8 9 7 1 X Y
Y X X 1 6 7 3 4 8 1 2 1 2 1 2 2 8 9 4 1 X X Y
Y Y X 2 5 4 7 8 7 5 6 1 3 5 7 8 7 2 9 3 X Y Y
Y Y X X 6 5 6 4 6 7 2 5 2 2 6 3 4 7 4 X X Y Y
Y Y Y X X 2 3 1 2 3 3 3 2 1 3 2 1 1 X X Y Y Y
Y Y Y Y X X X 7 4 4 5 7 3 4 4 7 X X X Y Y Y Y
Y Y Y Y Y Y X X X X 3 3 4 X X X X Y Y Y Y Y Y
Y Y Y Y Y Y Y Y Y X X X X X Y Y Y Y Y Y Y Y Y
